########################################
#......................................#
#......................................#
#....................................B.#
#......................................#
#......................................#
#......................................#
#......................................#
#.............................#........#
#........................#...#.........#
#....................#..#...#..........#
#..........B......#.#..#...#...........#
#.#####.########.################......#
#.....###............................B.#
#...............#1.....................#
#......................................#
#..............#.#.....................#
#.......B.....#...#.........B........B.#
#.......######..#..##########..........#
#......................................#
#..............#.#.....................#
#.............#...#....................#
#............#.....#...................#
#...........#.......#..................#
#..........#.........#.................#
#.......2.............#................#
#..........B...........#...............#
###############FF#######################
