########################################
########################################
########################################
########################################
########################################
########################################
##############.............#############
#########....................###########
######.........................#########
#...............................########
#................................###...#
#...................................1..#
###FF#####...............####......B.#.#
############..........#######.....###..#
#........###........#####....###....2.##
#.........###......###.......###...B..##
#............................###########
#..B.....................B...###########
#####.##################################
########################################
########################################
########################################
########################################
########################################
########################################
########################################
########################################
########################################
