########################################
########################################
########################################
########################################
########################################
########################################
##############.............#############
#########....................###########
######.........................#########
#...............................########
#................................###...#
#.................................B.1..#
###F.#####...............####........#.#
############..........#######.....###..#
#........###........#####....###..B.2.##
#.........###......###.......###......##
#....B...................B...###########
#............................###########
###.####################################
########################################
########################################
########################################
########################################
########################################
########################################
########################################
########################################
########################################
