########################################
#......................................#
#......................................#
#......................................#
#......................................#
#......................................#
#......................................#
#......................................#
#......................................#
#......................................#
#.............................#........#
#........................#...#.........#
#....................#..#...#..........#
#.................#.#..#...#...........#
#..............#.################......#
#......................................#
#...............#1.....................#
#......................................#
#..............#.#.....................#
#.......B.....#...#.........B..........#
#.......######..#..##########..........#
#......................................#
#..............#.#.....................#
#.............#...#....................#
#............#.....#...................#
#...........#.......#..................#
#..........#.........#.................#
#.......2.............#................#
#..........B...........#...............#
###############FF#######################
