########################################
########################################
########################################
#############################.......####
#############################.......####
#############################...2B.1####
#############################.......####
#############################...########
#############################...########
#############################...########
#############################.......####
#############################.......####
################################....####
###########....#################....####
##########......################....####
#########...B....############.......####
####.............###########........####
####.......####...#########.....########
####.......####..................#######
#####......####........B.........#######
#########F.####..................#######
####################..##################
####################..##################
########################################
########################################
########################################
########################################
########################################
